###############
#000$#00000000#
#0##$#00000000#
#0#0$#00$00000#
#0#$##00000000#
#0#00000000000#
#00$000$000000#
###00##########
#000000000000$#
###############