###############
#0000#00000000#
#0##0#00000000#
#0#00#00000000#
#0#0##00000000#
#0#00000000000#
#0000000000000#
###00##########
#000000000000$#
###############